Асура: ['Асура']
Балинъ: ['Балинъ']
Берестью: ['Берестью', 'Берестью', 'Берести', 'Берестью', 'Берестью', 'Берестью', 'Берестью', 'Берестьи']
Бужьиска: ['Бужьиска', 'Бужьскѣ', 'Бужескъ']
Бѣлу Вежю: ['Бѣлу Вежю']
Бѣлѣгородѣ: ['Бѣлѣгородѣ', 'Бѣльградъ', 'Бѣлагорода', 'Бѣлугороду', 'Бѣлагорода', 'Бѣлугороду', 'Бѣлъгородъ']
Вавилонъ: ['Вавилонъ', 'Вавилономъ', 'Вавилонъ', 'Вавилона', 'Вавилонъ']
Вефили: ['Вефили']
Володимеръ: ['Володимеръ', 'Володимеромъ', 'Володимиря', 'Володимиръ', 'Володимеру', 'Володимира', 'Володимира', 'Володимиръ', 'Володимиръ', 'Володимиръ', 'Володимиръ', 'Володимира', 'Володимера', 'Володимири', 'Володимиръ', 'Володимиръ', 'Володимиръ', 'Володимиру', 'Володимиръ', 'Володимиръ', 'Володимиром', 'Володимиру', 'Володимирю', 'Володимиръ', 'Володимеру', 'Володимиръ', 'Володимиру', 'Володимира', 'Володимиръ', 'Володимиръ', 'Володимира', 'Володимеру', 'Володимиръ', 'Володимиръ', 'Володимиръ', 'Володимиръ', 'Володимиръ', 'Володимеръ', 'Володимиръ', 'Володимиръ', 'Володимиръ', 'Володимиръ', 'Володимиръ', 'Володимиру', 'Володимиръ', 'Владимиръ', 'Володимиръ', 'Володимиръ', 'Володимиръ', 'Володимиръ', 'Володимиръ', 'Володимиръ', 'Володимиру', 'Володимиръ', 'Володимиръ', 'Володимиръ', 'Володимиръ', 'Володимиръ', 'Володимиръ', 'Вълодимер', 'Вълодимеръ', 'Вълодимер', 'Вълодимерь', 'Володимѣръ', 'Володимеръ', 'Володимѣръ', 'Володимеръ', 'Володимѣръ', 'Володимеръ', 'Володимеръ', 'Володимеръ', 'Володимеръ', 'Володимеръ', 'Володимеръ', 'Володимиръ', 'Володимѣръ', 'Володимеру', 'Володимиръ', 'Володимиръ', 'Володимеръ', 'Володимѣра', 'Володимеръ', 'Володимѣря', 'Володимеру', 'Володимеръ', 'Володимеръ', 'Володимиръ', 'Володимѣръ', 'Володимѣръ', 'Володимера', 'Володимиръ', 'Володимѣрѣ', 'Володимеръ', 'Володимиру', 'Володимѣръ', 'Володимиръ', 'Володимеръ', 'Володимеръ', 'Володимира', 'Володимеръ', 'Володимѣръ', 'Володимѣръ', 'Володимѣръ', 'Володимѣръ', 'Володимѣръ', 'Володимиръ', 'Володимиръ', 'Володимиръ', 'Володимѣръ', 'Володимѣръ', 'Володимѣръ', 'Володимѣръ', 'Володимеръ', 'Володимиръ', 'Володимиръ', 'Володимиръ', 'Володимеру', 'Володимеръ', 'Володимиръ', 'Володимиръ', 'Володимеру', 'Володимиру', 'Володимѣрь', 'Вълодимѣрь', 'Володимеряа', 'Володимиръ', 'Володимѣру', 'Володимеру', 'Володимиръ', 'Володимиръ', 'Володимеръ', 'Володимира', 'Володимиръ', 'Володимерь', 'Володимеръ', 'Володимиръ', 'Володимерь', 'Володимира', 'Володимирь', 'Володимѣрѣ', 'Володимеръ', 'Володимѣри', 'Володимирь', 'Володимиръ', 'Володимѣрь', 'Володимиръ', 'Володимерѣ', 'Володимерѣ', 'Володимеря', 'Володимирь', 'Володимеръ', 'Володимера', 'Володимеру', 'Володимером', 'Володимеръ', 'Володимера', 'Володимерѣ', 'Володимера', 'Володимер', 'Володимера', 'Володимерѣ', 'Володимера', 'Володимеру', 'Володимеру', 'Володимерѣ', 'Володимеромъ', 'Володимеръ', 'Володимерѣ', 'Володимерю', 'Володимеремь', 'Володимера', 'Володимеръ', 'Володимера', 'Володимеру', 'Володимеру', 'Володимер', 'Володимеръ', 'Володимеру', 'Володимеру', 'Володимеръ', 'Володимеру', 'Володимеръ', 'Володимеръ', 'Володимеръ', 'Володимеръ', 'Володимерь', 'Володимеръ', 'Володимера', 'Володимеръ', 'Володимеръ', 'Володимерь', 'Володимерь', 'Володимеръ', 'Володимеру', 'Володимерь', 'Володимеру', 'Володимеровъ', 'Володимеру', 'Володимеру', 'Володимерь', 'Володимерь', 'Володимеръ', 'Володимерь', 'Володимерь', 'Володимеръ', 'Володимеръ', 'Володимерича', 'Володимерь', 'Володимеръ', 'Володимеръ', 'Володимеръ', 'Володимеръ', 'Володимеръ', 'Володимеръ', 'Володимеръ', 'Володимеръ', 'Володимеръ', 'Володимеря', 'Володимерь', 'Володимерь', 'Володимерь', 'Володимерь', 'Володимеръ', 'Володимеръ', 'Володимерь', 'Володимеръ', 'Володимеромъ', 'Володимеръ', 'Володимери', 'Володимеромъ', 'Володимерю', 'Володимерю', 'Вълодимеръ', 'Володимеру', 'Володимеру', 'Володимеръ', 'Володимѣромъ', 'Володимеру', 'Володимери', 'Володимери', 'Володимеру', 'Володимеру', 'Володимерю', 'Володимеръ', 'Володимеръ', 'Володимера', 'Володимери', 'Володимѣрѣ', 'Володимеръ', 'Володимеру', 'Володимеръ', 'Володимеру', 'Володимеру', 'Володимера', 'Володимерю', 'Володимерѣ', 'Володимерю', 'Володимерю', 'Володимерю', 'Володимерю', 'Володимери', 'Володимерю', 'Володимерь', 'Володимеръ', 'Володимеря', 'Володимерь', 'Володимеръ', 'Володимеръ', 'Володимеръ', 'Володимерю', 'Володимеремь', 'Володимери', 'Володимеръ', 'Володимеръ', 'Володимеръ', 'Володимеръ', 'Володимеръ', 'Володимеръ', 'Володимеръ', 'Володимеръ', 'Володимерь', 'Володимеромь', 'Володимери', 'Володимеру', 'Володимери', 'Володимеръ', 'Володимерю', 'Володимера', 'Володимеру', 'Володимеръ', 'Володимеръ', 'Володимеръ', 'Володимерь', 'Володимеричь', 'Володимеру', 'Володимеръ', 'Володимеръ', 'Володимеръ', 'Володимерю', 'Володимеря', 'Володимеръ', 'Володимеръ', 'Володимеръ', 'Володимеромъ', 'Володимеръ', 'Володимеру', 'Володимерю', 'Володимерю', 'Володимеру', 'Володимеръ', 'Володимеръ', 'Володимеръ', 'Володимеръ', 'Володимеръ', 'Володимеръ', 'Володимеръ', 'Володимеръ', 'Володимеръ', 'Володимеру', 'Володимеръ', 'Володимеру', 'Володимерю', 'Володимерьну', 'Володимѣра', 'Володимеру', 'Володимеръ', 'Володимеру', 'Володимеръ', 'Володимѣря', 'Володимеръ', 'Володимеръ', 'Володимеръ', 'Володимеръ', 'Володимеръ', 'Володимеръ', 'Володимеромъ', 'Володимеру', 'Володимеръ', 'Володимеръ', 'Володимеръ', 'Володимеру', 'Володимеръ', 'Володимеръ', 'Володимеръ', 'Володимеру', 'Володимеръ', 'Володимеру', 'Володимера', 'Володимеръ', 'Володимеричь', 'Володимерь', 'Володимеръ', 'Володимеръ', 'Володимеру', 'Володимерь', 'Володимеръ', 'Володимеровъ', 'Володимеръ', 'Володимерю', 'Володимери', 'Володимеромъ', 'Володимеръ', 'Володимеръ', 'Володимеръ', 'Володимеръ', 'Володимерь']
Вручий: ['Вручий', 'Вручего', 'Въручего']
Вышегороду: ['Вышегороду', 'Вышегородъ', 'Вышегородѣ', 'Вышегороду', 'Вышегороду', 'Вышегороду', 'Вышегородъ', 'Вышегородѣ', 'Вышегородомь', 'Вышегородъ', 'Вышегородомъ', 'Вышегородѣ']
Гомору: ['Гомору']
Городьца: ['Городьца', 'Городчю', 'Городцю', 'Городца', 'Городцю']
Деръстеръ: ['Деръстеръ', 'Дерестѣръ', 'Дерьстеръ', 'Дерьстрѣ', 'Дерьстрѣ']
Дорогобужь: ['Дорогобужь', 'Дорогобужю', 'Дорогобужь', 'Дорогобужь']
Дрьюцька: ['Дрьюцька', 'Дрьютескъ']
Дубенъ: ['Дубенъ']
Енданѣ: ['Енданѣ']
Звенигороду: ['Звенигороду', 'Звенигороду']
Иерусадимѣ: ['Иерусадимѣ', 'Ерусалимъ', 'Ерусалимѣ', 'Иерусалима', 'Иерусалимъ', 'Иерусалимѣ', 'Иерусалимъ', 'Ерусалима', 'Ерусалимѣ', 'Ерусалимъ', 'Ерусалимѣ', 'Ерусалимъ', 'Ерусалимъ', 'Иерусалиму', 'Ерусалими', 'Ерусалимъ', 'Иерусолима', 'Ерусалимѣ', 'Иерусолимѣ']
Изборьсцѣ: ['Изборьсцѣ']
Искоростѣня: ['Искоростѣня', 'Искоростиня', 'Искоростѣнь']
Киевъ: ['Киевъ', 'Киевъ', 'Киева', 'Киевъ', 'Киевѣць', 'Киеви', 'Киевъ', 'Киевъ', 'Киевѣ', 'Киевѣ', 'Киевъ', 'Кыевѣ', 'Киевъ', 'Киева', 'Киеву', 'Киевѣ', 'Киеву', 'Киеву', 'Киева', 'Киевѣ', 'Киевѣ', 'Киевъ', 'Киеву', 'Киеву', 'Киеву', 'Киевъ', 'Киевъ', 'Киеву', 'Киеву', 'Киеву', 'Киевѣ', 'Киевъ', 'Киеву', 'Киевѣ', 'Кыевѣ', 'Киеву', 'Киева', 'Киеву', 'Киевѣ', 'Киевъ', 'Киевѣ', 'Киеву', 'Киеву', 'Кыевѣ', 'Кыеву', 'Кыева', 'Киевь', 'Кыеву', 'Кыеву', 'Кыеву', 'Кыевѣ', 'Киевѣ', 'Кыевѣ', 'Кыевѣ', 'Кыева', 'Киевѣ', 'Кыевѣ', 'Кыевѣ', 'Кыевъ', 'Кыевъ', 'Кыевѣ', 'Кыева', 'Кыевѣ', 'Кыевѣ', 'Кыева', 'Кыеву', 'Кыевѣ', 'Кыевъ', 'Киевѣ', 'Кыеву', 'Кыевъ', 'Кыеву', 'Кыевъ', 'Кыеву', 'Кыевѣ', 'Кыевъ', 'Кыеву', 'Киевѣ', 'Кыевѣ', 'Кыеву', 'Кыеву', 'Кыеву', 'Кыевѣ', 'Кыевѣ', 'Кыеву', 'Кыеву', 'Кыеву', 'Кыеву', 'Кыева', 'Кыевъ', 'Кыевѣ', 'Кыевѣ', 'Киевѣ', 'Кыеву', 'Киевъ', 'Киевъ', 'Киеви', 'Киевѣ', 'Киеву', 'Киеву', 'Киевѣ', 'Киевѣ', 'Киевѣ', 'Киевѣ', 'Киеву', 'Киеву', 'Кыеву', 'Кыеву', 'Кыеву', 'Кыевъ', 'Кыеву', 'Кыева', 'Кыеву', 'Кыеву', 'Кыеву', 'Кыевъ', 'Кыеву', 'Кыева', 'Киеву', 'Киеву', 'Киевъ', 'Кыеву', 'Киевѣ', 'Киева', 'Киевѣ', 'Кыева', 'Кыеву', 'Кыеву', 'Кыеву', 'Киеву', 'Киева', 'Кыева', 'Кыеву', 'Киеву', 'Киеву', 'Киевъ', 'Киевѣ', 'Киеву']
Корсунь: ['Корсунь', 'Коръсуня', 'Корсунь', 'Корсуню', 'Корсуни', 'Корсуни', 'Корсунѣ', 'Корсунь', 'Корсуни']
Костянтинѣградѣ: ['Костянтинѣградѣ']
Ладогу: ['Ладогу', 'Ладозѣ', 'Ладога', 'Ладогу']
Лубна: ['Лубна', 'Лубьну']
Лучьскѣ: ['Лучьскѣ', 'Лучску', 'Лучька', 'Лучьску', 'Лутцьку', 'Лучьку', 'Лучьку', 'Луческъ']
Любечь: ['Любечь', 'Любечь', 'Любчю', 'Любча', 'Любчи']
Муромѣ: ['Муромѣ', 'Муромѣ', 'Муромъ', 'Мурому', 'Мурому', 'Муромѣ', 'Мурому', 'Мурому', 'Мурому', 'Мурому', 'Муромѣ', 'Мурому']
Мѣньску: ['Мѣньску', 'Мѣнескъ', 'Менескъ', 'Мѣньску', 'Мѣньску', 'Менескъ', 'Мѣньска']
Новъгородъ: ['Новъгородъ', 'Новъгород', 'Новѣгородѣ', 'Новъгород', 'Новѣгородѣ', 'Новѣгородѣ', 'Новагорода', 'Новугороду', 'Новугороду', 'Новѣгородѣ', 'Новѣгородѣ', 'Новугороду', 'Новѣгородѣ', 'Новѣгородѣ', 'Новугороду', 'Новѣгородѣ', 'Новѣгородѣ', 'Новѣгородѣ', 'Новугороду', 'Новѣгородѣ', 'Новѣгородѣ', 'Новугороду', 'Новугороду', 'Новъгородъ', 'Новъгородъ', 'Новугороду', 'Новѣгородѣ', 'Новѣгородѣ', 'Новугороду', 'Новугороду', 'Новѣгородѣ', 'Новугороду', 'Новѣгородѣ', 'Новѣгородѣ', 'Новѣгородѣ', 'Новѣгородѣ', 'Новѣгородѣ', 'Новъгородъ', 'Новгородцю', 'Новѣгородѣ', 'Новѣгородѣ', 'Новагорода', 'Новагорода', 'Новугороду', 'Новѣгородѣ', 'Новугороду', 'Новугороду', 'Новагорода', 'Новъгородъ', 'Новугороду', 'Новугороду', 'Новѣгородѣ', 'Новугороду', 'Новугороду', 'Новугороду', 'Новѣгородѣ', 'Новъгородъ', 'Новагорода', 'Новѣгородѣ']
Переволоку: ['Переволоку']
Перемышль: ['Перемышль', 'Перемышля', 'Перемышлю', 'Перемышль', 'Перемышля', 'Перемышля', 'Перемышль']
Переяславлъ: ['Переяславлъ', 'Переяславля', 'Переяславля', 'Переяславль', 'Переяславль', 'Переяславль', 'Переяславлѣ', 'Переяславля', 'Переяславлѣ', 'Переяславлѣ', 'Переяславлю', 'Переяславля', 'Переяславля', 'Переяславль', 'Переяславля', 'Переяславлю', 'Переяславли', 'Переяславлю', 'Переяславлю', 'Переяславлѣ', 'Переяславля', 'Переяславлѣ', 'Переяславлѣ', 'Переяславлѣ']
Плескова: ['Плескова', 'Плесъковѣ', 'Плесковѣ']
Полътескъ: ['Полътескъ', 'Полотьскѣ', 'Полътескъ', 'Полотьску', 'Полотьскѣ', 'Полотескъ', 'Полотьсцѣ', 'Полотьску', 'Полотьску', 'Полотьский', 'Полотьску', 'Полотьска', 'Полотьскѣ', 'Полотьска', 'Полотьскѣ', 'Полотьскѣ']
Прилукъ: ['Прилукъ']
Припеть: ['Припеть', 'Припѣтью', 'Припетѣ']
Пѣсоченъ: ['Пѣсоченъ']
Рима: ['Рима', 'Рима', 'Рима', 'Рима', 'Римъ', 'Римъ', 'Римѣ', 'Рима', 'Рима', 'Рима', 'Римъ', 'Рима', 'Рима', 'Рима', 'Рима', 'Рима', 'Римъ', 'Рима', 'Рима']
Роднѣ: ['Роднѣ', 'Роднѣ']
Ростовѣ: ['Ростовѣ', 'Ростовъ', 'Ростовѣ', 'Ростовъ', 'Ростовѣ', 'Ростовѣ', 'Ростовѣ', 'Ростову', 'Ростову', 'Ростову', 'Ростову', 'Ростова', 'Ростову', 'Ростову']
Рши: ['Рши', 'Ръшю']
Рязаню: ['Рязаню', 'Рязаню', 'Рязаню', 'Рязаня']
Селуня: ['Селуня', 'Селуни', 'Селунь']
Смолѣнескъ: ['Смолѣнескъ', 'Смольнескъ', 'Смоленьску', 'Смоленьска', 'Смолнескь', 'Смолѣньсцѣ', 'Смоленьский', 'Смолѣньсцѣ', 'Смоленьска', 'Смоленьскѣ', 'Смоленьску', 'Смоленьскѣ', 'Смоленьску', 'Смоленьску', 'Смоленьску', 'Смоленьскѣ', 'Смоленьскѣ', 'Смоленьска']
Содому: ['Содому']
Сугрову: ['Сугрову', 'Сугровъ']
Суждалю: ['Суждалю', 'Суждалю', 'Суждаль', 'Суждалю', 'Суждалю', 'Суждаль', 'Суждалю', 'Суждалю']
Теребовлъ: ['Теребовлъ', 'Теребовль', 'Теребовли']
Тмутороканѣ: ['Тмутороканѣ', 'Тмуторокани', 'Тьмутороканю', 'Тмутороканѣ', 'Тьмуторокана', 'Тмутороканю', 'Тмуторокана', 'Тмутороканю', 'Тмутороканю', 'Тмутороканѣ', 'Тмуторокани', 'Тмутороканю', 'Тмутороканю', 'Тмютороканю', 'Тмутороканю', 'Тмутороканю', 'Тмутороканю', 'Тмутороканю', 'Тмуторокани', 'Тмутороканя']
Торъчьский: ['Торъчьский', 'Торочьскому', 'Торочьский', 'Торочкому', 'Торъческому']
Треполю: ['Треполю', 'Треполь', 'Треполь', 'Треполя', 'Треполя']
Турийську: ['Турийську', 'Турийскѣ']
Туровѣ: ['Туровѣ', 'Туровѣ', 'Туровѣ', 'Туровъ', 'Турову', 'Турову', 'Турова', 'Туровъ']
Хорола: ['Хорола', 'Хоролѣ']
Цесарюграду: ['Цесарюграду', 'Царяграда', 'Цесарюграду', 'Цесарьград', 'Цесарюграду', 'Цесарьград', 'Цесарьград', 'Цесарюграду', 'Цесаряграда', 'Цесарьград', 'Цесарьград', 'Цесарюграду', 'Цесарьград', 'Цесарьград', 'Цесарьград', 'Цесарюграду', 'Цесарюграду', 'Цесарюграду', 'Цесарюграду', 'Цесарѣградѣ', 'Цесарѣградѣ', 'Цесаряграда', 'Цесаряграда', 'Цесаряграда', 'Цесаряграда', 'Цесаряграда', 'Цесаряграда', 'Цесарьград', 'Цесарюграду', 'Цесарюграду', 'Царюгороду', 'Цесарюграду']
Червенъ: ['Червенъ', 'Червенъ']
Черниговъ: ['Черниговъ', 'Чернигова', 'Чернигова', 'Черниговѣ', 'Черниговъ', 'Черниговѣ', 'Чернигову', 'Черниговѣ', 'Чернигова', 'Черниговъ', 'Чернигову', 'Чернигову', 'Чернигову', 'Черниговѣ', 'Чернѣговѣ', 'Черниговѣ', 'Чернигову', 'Чернигову', 'Черниговѣ', 'Черниговѣ', 'Чернѣгову', 'Чернѣгову', 'Черниговѣ', 'Чернѣгову', 'Чернѣгову', 'Чернигову', 'Чернигова', 'Чернигову', 'Черьнѣгова', 'Чернѣгову', 'Чернѣгову']
Черторыескъ: ['Черторыескъ']
Шарукань: ['Шарукань', 'Шарукань', 'Шаруканю', 'Шаруканъ']
Шеполь: ['Шеполь']
Юрьевъ: ['Юрьевъ', 'Гурьгову', 'Гюргевь', 'Гурьговъ', 'Гургеву']
